....................
....................
######..............
....................
....................
......#.............
......#.............
....................
.............####...
....................
......#.............
...##.#.............
......#.............
......#.............
......#######.......